2,2,2,3,2,2,2,2,2,2,2,2,
2,2,3,3,2,2,2,4,5,2,2,2,
2,2,3,3,2,2,2,4,2,2,2,2,
2,3,3,2,2,2,2,4,2,2,2,2,
3,3,2,2,4,4,4,4,2,2,2,2,
2,2,2,2,4,2,2,4,2,2,2,2,
2,2,2,2,4,2,2,4,2,2,2,2,
2,1:0,4,4,4,4,4,4,4,4,1:1,2,
2,2,2,2,2,2,2,2,2,2,2,2,
2,2,2,2,2,2,2,2,2,2,2,2,
2,2,2,2,2,2,2,2,2,2,2,2,
2,2,2,2,2,2,2,2,2,2,2,2,
